{
    "name": "Level 3 Heaven",
    "positions": [
        [0, 0, 0, 0, 0, 7, 0, 0, 0, 0, 0, 1, 1],
        [0, 0, 7, 0, 0, 0, 0, 0, 0, 1, 1, 1, 1],
        [0, 0, 0, 0, 0, 0, 0, 0, 1, 1, 1, 8, 8],
        [7, 0, 0, 1, 1, 0, 0, 0, 0, 1, 1, 1, 1],
        [0, 0, 1, 1, 1, 1, 0, 0, 0, 0, 0, 0, 0],
        [0, 1, 1, 8, 8, 1, 1, 0, 7, 0, 0, 7, 0],
        [0, 0, 1, 1, 1, 1, 1, 0, 0, 0, 7, 0, 0],
        [0, 0, 7, 0, 0, 0, 0, 0, 0, 0, 0, 0, 7]
    ]
}