{
    "name": "Level 1 Castle",
    "positions": [
        [0, 0, 0, 0, 0, 0, 0, 0, 0, 0, 0, 0, 0, 0, 0],
        [0, 0, 1, 1, 1, 1, 1, 1, 0, 0, 0, 0, 0, 0, 0],
        [0, 0, 0, 1, 1, 1, 1, 0, 0, 0, 0, 6, 0, 0, 0],
        [0, 0, 0, 0, 1, 1, 0, 0, 0, 0, 6, 6, 6, 0, 0],
        [0, 0, 0, 0, 1, 1, 0, 0, 0, 5, 0, 6, 0, 5, 0],
        [0, 0, 0, 0, 1, 1, 0, 0, 0, 0, 5, 5, 5, 0, 0],
        [0, 0, 0, 0, 1, 1, 0, 0, 0, 0, 0, 5, 0, 0, 0],
        [0, 0, 0, 1, 1, 1, 1, 0, 0, 0, 0, 5, 0, 0, 0],
        [0, 0, 1, 1, 1, 1, 1, 1, 0, 0, 5, 0, 5, 0, 0],
        [0, 0, 0, 0, 0, 0, 0, 0, 0, 0, 5, 0, 5, 0, 0]
    ]
}