{
    "name": "Level 3 Castle",
    "positions": [
        [0, 0, 0, 7, 7, 0, 0, 0, 0, 0, 7, 7, 0, 0, 0],
        [0, 0, 7, 7, 7, 7, 0, 0, 0, 7, 7, 7, 7, 0, 0],
        [0, 0, 0, 6, 6, 0, 0, 0, 0, 0, 6, 6, 0, 0, 0],
        [0, 0, 0, 6, 6, 0, 0, 0, 0, 0, 6, 6, 0, 0, 0],
        [0, 0, 0, 6, 6, 5, 5, 5, 5, 5, 6, 6, 0, 0, 0],
        [0, 0, 0, 6, 6, 5, 5, 5, 5, 5, 6, 6, 0, 0, 0],
        [0, 0, 0, 6, 6, 0, 0, 0, 0, 5, 6, 6, 0, 0, 0],
        [0, 0, 0, 6, 6, 0, 0, 0, 0, 5, 6, 6, 0, 0, 0],
        [0, 0, 0, 6, 6, 0, 0, 0, 0, 5, 6, 6, 0, 0, 0],
        [0, 0, 0, 6, 6, 0, 0, 0, 0, 5, 6, 6, 0, 0, 0]
    ]
}