{
    "name": "Level 2 Mountain",
    "positions": [
        [0, 0, 0, 0, 7, 0, 0, 0, 0, 0, 7, 0, 0],
        [0, 0, 0, 7, 0, 7, 0, 0, 0, 7, 0, 7, 0],
        [7, 0, 7, 0, 0, 0, 7, 0, 7, 0, 0, 0, 7],
        [0, 7, 0, 0, 8, 0, 0, 7, 0, 0, 8, 0, 0],
        [0, 0, 0, 8, 0, 8, 0, 0, 0, 8, 0, 8, 0],
        [8, 0, 8, 0, 0, 0, 8, 0, 8, 0, 0, 0, 8],
        [0, 8, 0, 0, 0, 0, 0, 8, 0, 0, 0, 0, 0],
        [0, 0, 0, 0, 0, 0, 0, 0, 0, 0, 0, 0, 0]
    ]
}