{
    "name": "Level 2 Water",
    "positions": [
		[0, 0, 0, 0, 1, 1, 1, 1, 0, 0, 0],
        [0, 0, 0, 1, 2, 2, 2, 2, 1, 0, 0],
        [5, 0, 0, 1, 2, 0, 0, 2, 1, 0, 0],
        [5, 5, 0, 1, 2, 0, 0, 2, 1, 0, 5],
        [5, 0, 0, 0, 1, 2, 2, 1, 0, 5, 5],
        [0, 0, 0, 1, 0, 0, 0, 0, 1, 0, 5],
        [0, 0, 0, 1, 1, 1, 1, 1, 1, 0, 0]
    ]
}