{
    "name": "Level 3 Water",
    "positions": [
		[0, 0, 0, 0, 2, 2, 0, 0, 0, 0, 0],
        [0, 0, 0, 1, 5, 5, 0, 0, 0, 3, 0],
        [0, 0, 1, 4, 5, 5, 5, 0, 3, 2, 0],
        [0, 1, 1, 1, 5, 5, 5, 3, 1, 2, 0],
        [0, 0, 1, 1, 5, 5, 0, 0, 3, 2, 0],
        [0, 0, 0, 1, 2, 2, 0, 0, 0, 3, 0],
        [0, 0, 0, 0, 0, 2, 2, 0, 0, 0, 0]
    ]
}