{
    "name": "Level 3 Village",
    "positions": [
        [0, 0, 0, 0, 6, 6, 6, 6, 6, 0, 0, 0, 0],
        [0, 0, 0, 6, 0, 0, 0, 0, 0, 6, 0, 0, 0],
        [0, 0, 6, 0, 0, 0, 0, 0, 0, 0, 6, 0, 0],
        [0, 0, 6, 0, 0, 4, 0, 4, 0, 0, 6, 0, 0],
        [0, 0, 6, 0, 1, 0, 0, 0, 1, 0, 6, 0, 0],
        [0, 0, 6, 0, 1, 0, 0, 0, 1, 0, 6, 0, 0],
        [0, 0, 6, 0, 1, 0, 0, 0, 1, 0, 6, 0, 0],
        [0, 0, 6, 0, 0, 4, 0, 4, 0, 0, 6, 0, 0],
        [0, 0, 0, 6, 0, 0, 0, 0, 0, 6, 0, 0, 0],
        [0, 0, 0, 0, 6, 6, 6, 6, 6, 0, 0, 0, 0]
    ]
}