{
    "name": "Level 1 Village",
    "positions": [
        [0, 0, 0, 0, 0, 0, 0, 0, 0, 0, 0, 0, 0],
        [0, 0, 0, 0, 0, 0, 0, 0, 0, 0, 0, 0, 0],
        [0, 0, 2, 2, 0, 0, 2, 2, 0, 0, 2, 2, 0],
        [0, 0, 2, 2, 0, 0, 2, 2, 0, 0, 2, 2, 0],
        [0, 0, 0, 0, 2, 2, 0, 0, 2, 2, 0, 0, 0],
        [0, 0, 0, 0, 2, 2, 0, 0, 2, 2, 0, 0, 0],
        [0, 0, 2, 2, 0, 0, 2, 2, 0, 0, 2, 2, 0],
        [0, 0, 2, 2, 0, 0, 2, 2, 0, 0, 2, 2, 0],
        [0, 0, 0, 0, 0, 0, 0, 0, 0, 0, 0, 0, 0],
        [0, 0, 0, 0, 0, 0, 0, 0, 0, 0, 0, 0, 0]
    ]
}