{
    "name": "Level 2 Forest",
    "positions": [
        [0, 0, 2, 1, 2, 0, 0, 2, 1, 2, 0, 0, 0],
        [0, 0, 2, 1, 2, 0, 0, 2, 1, 2, 0, 0, 0],
        [0, 0, 2, 1, 2, 0, 0, 2, 1, 2, 0, 0, 0],
        [0, 0, 0, 1, 0, 0, 0, 0, 1, 0, 0, 0, 0],
        [0, 0, 0, 1, 0, 0, 0, 0, 1, 0, 0, 0, 0],
        [0, 0, 0, 1, 0, 0, 0, 0, 1, 0, 0, 0, 0],
        [0, 0, 0, 1, 0, 0, 0, 0, 1, 0, 0, 0, 0],
        [0, 0, 0, 1, 0, 0, 0, 0, 1, 0, 0, 0, 0]
    ]
}