{
    "name": "Level 3 Forest",
    "positions": [
        [0, 1, 0, 0, 0, 0, 0, 1, 0],
        [1, 2, 1, 0, 0, 0, 1, 2, 1],
        [1, 2, 1, 0, 0, 0, 1, 2, 1],
        [1, 5, 1, 0, 0, 0, 1, 5, 1],
        [0, 5, 0, 0, 0, 0, 0, 5, 0],
        [0, 5, 0, 0, 0, 0, 0, 5, 0],
        [0, 5, 0, 0, 0, 0, 0, 5, 0]
    ]
}