{
    "name": "Level 2 Forest",
    "positions": [
        [0, 0, 0, 0, 6, 6, 1, 0, 0, 0, 0, 0, 0],
        [0, 0, 0, 0, 5, 5, 1, 0, 0, 0, 0, 0, 0],
        [0, 0, 0, 0, 4, 4, 1, 0, 0, 0, 0, 0, 0],
        [0, 0, 0, 0, 1, 1, 1, 1, 0, 0, 0, 0, 0],
        [0, 0, 0, 0, 1, 1, 1, 1, 1, 0, 0, 0, 0],
        [0, 0, 0, 0, 1, 1, 1, 1, 1, 0, 0, 0, 0],
        [0, 0, 0, 0, 1, 1, 1, 1, 1, 0, 0, 0, 0],
        [0, 0, 0, 0, 1, 1, 1, 1, 0, 0, 0, 0, 0]
    ]
}