{
    "name": "Level 5 Forest",
    "positions": [
        [0, 0, 0, 0, 0, 0, 0, 1, 2, 3, 4, 5, 6],
        [0, 0, 0, 0, 0, 0, 1, 2, 3, 4, 5, 6, 7],
        [0, 0, 0, 0, 0, 1, 2, 3, 4, 5, 6, 7, 0],
        [0, 0, 0, 0, 1, 2, 3, 4, 5, 6, 7, 0, 0],
        [0, 0, 0, 1, 2, 3, 4, 5, 6, 7, 0, 0, 0],
        [0, 0, 1, 2, 3, 4, 5, 6, 7, 0, 0, 0, 0],
        [0, 1, 2, 3, 4, 5, 6, 7, 0, 0, 0, 0, 0],
        [1, 2, 3, 4, 5, 6, 7, 0, 0, 0, 0, 0, 0]
    ]
}