{
    "name": "Level 2 Forest",
    "positions": [
		[0, 1, 1, 0, 0, 0, 0, 0, 0],
        [0, 1, 0, 1, 0, 0, 0, 2, 2],
        [0, 1, 0, 0, 1, 0, 0, 2, 2],
        [0, 1, 0, 0, 1, 0, 0, 0, 0],
        [0, 0, 1, 1, 0, 0, 0, 0, 0],
        [0, 0, 0, 1, 1, 0, 0, 0, 0],
        [0, 0, 0, 0, 0, 1, 0, 0, 0]
    ]
}