{
    "name": "Level 1 Desert",
    "positions": [
        [0, 0, 5, 5, 5, 0, 0, 0, 0],
        [0, 5, 0, 0, 0, 5, 5, 0, 0],
        [0, 0, 4, 4, 0, 0, 0, 0, 0],
        [0, 4, 1, 6, 4, 4, 4, 0, 0],
        [0, 0, 4, 4, 0, 0, 0, 0, 0],
        [0, 0, 4, 0, 4, 0, 0, 0, 0],
        [0, 0, 4, 0, 0, 4, 0, 0, 0]
    ]
}