{
    "name": "Level 1 Desert",
    "positions": [
        [0, 0, 0, 0, 3, 0, 0, 0, 0],
        [1, 1, 1, 0, 0, 0, 1, 1, 1],
        [0, 1, 0, 0, 2, 0, 0, 1, 0],
        [6, 0, 0, 2, 4, 2, 0, 0, 6],
        [0, 5, 0, 0, 2, 0, 0, 5, 0],
        [5, 5, 5, 0, 0, 0, 5, 5, 5],
        [0, 0, 0, 0, 3, 0, 0, 0, 0]
    ]
}