{
    "name": "Level 3 Snowy",
    "positions": [
        [1, 0, 1, 0, 1, 0, 1, 0, 1, 0, 1],
        [0, 1, 0, 1, 0, 1, 0, 1, 0, 1, 0],
        [1, 0, 1, 0, 1, 0, 1, 0, 1, 0, 1],
        [0, 1, 0, 1, 0, 1, 0, 1, 0, 1, 0],
        [1, 0, 1, 0, 1, 0, 1, 0, 1, 0, 1],
        [0, 1, 0, 1, 0, 1, 0, 1, 0, 1, 0],
        [1, 0, 1, 0, 1, 0, 1, 0, 1, 0, 1]
    ]
}