{
    "name": "Level 2 Snowy",
    "positions": [
        [0, 0, 6, 0, 5, 5, 5, 0, 6, 0, 0],
        [0, 0, 0, 6, 0, 5, 0, 6, 0, 0, 0],
        [0, 0, 5, 0, 6, 5, 6, 0, 5, 0, 0],
        [0, 0, 5, 5, 5, 6, 5, 5, 5, 0, 0],
        [0, 0, 5, 0, 6, 5, 6, 0, 5, 0, 0],
        [0, 0, 0, 6, 0, 5, 0, 6, 0, 0, 0],
        [0, 0, 6, 0, 5, 5, 5, 0, 6, 0, 0]
    ]
}