{
    "name": "Level 3 Universe",
    "positions": [
        [1, 1, 1, 1, 1, 1, 1, 1, 1, 1, 1, 1, 1, 1, 1, 1, 1, 1, 1, 1, 1, 1, 1, 1, 1, 1],
        [1, 1, 1, 1, 1, 1, 1, 1, 1, 1, 1, 1, 1, 1, 1, 1, 1, 1, 1, 1, 1, 1, 1, 1, 1, 1],
        [1, 1, 1, 1, 1, 1, 1, 1, 1, 1, 1, 1, 1, 1, 1, 1, 1, 1, 1, 1, 1, 1, 1, 1, 1, 1],
        [1, 1, 1, 1, 1, 1, 1, 1, 1, 1, 1, 1, 1, 1, 1, 1, 1, 1, 1, 1, 1, 1, 1, 1, 1, 1],
        [1, 1, 5, 5, 1, 1, 1, 1, 1, 1, 1, 1, 1, 1, 1, 1, 1, 1, 1, 1, 1, 1, 1, 1, 1, 1],
        [1, 1, 5, 1, 5, 1, 1, 1, 1, 1, 1, 1, 1, 1, 1, 1, 1, 1, 1, 1, 1, 1, 1, 1, 1, 1],
        [1, 1, 5, 1, 5, 1, 1, 1, 1, 1, 1, 1, 6, 1, 6, 7, 7, 7, 1, 1, 1, 8, 1, 1, 1, 1],
        [1, 1, 5, 1, 5, 1, 6, 1, 5, 1, 1, 5, 6, 1, 6, 7, 1, 1, 1, 1, 1, 8, 1, 1, 1, 1],
        [1, 1, 5, 1, 5, 6, 1, 6, 5, 5, 1, 5, 6, 6, 1, 7, 7, 7, 1, 1, 1, 8, 1, 1, 1, 1],
        [1, 1, 5, 1, 5, 6, 6, 6, 5, 1, 5, 5, 6, 1, 6, 7, 1, 1, 1, 1, 1, 8, 1, 1, 1, 1],
        [1, 1, 5, 5, 1, 6, 1, 6, 5, 1, 1, 5, 6, 1, 6, 7, 7, 7, 1, 1, 1, 8, 1, 1, 1, 1],
        [1, 1, 1, 1, 1, 1, 1, 1, 1, 1, 1, 1, 1, 1, 1, 1, 1, 1, 1, 1, 1, 1, 1, 1, 1, 1],
        [1, 1, 1, 1, 1, 1, 1, 1, 1, 1, 1, 1, 1, 1, 1, 1, 1, 1, 1, 1, 1, 1, 1, 1, 1, 1] 
    ]
}