{
    "name": "Level 2 Universe",
    "positions": [
        [1, 0, 0, 0, 0, 0, 4, 0, 0, 0, 0, 0, 1, 1, 0, 0, 0, 0, 0, 4, 0, 0, 0, 0, 0, 1],
        [0, 0, 0, 0, 1, 0, 0, 0, 1, 0, 0, 0, 0, 0, 0, 0, 0, 1, 0, 0, 0, 1, 0, 0, 0, 0],
        [0, 0, 0, 1, 1, 1, 0, 1, 1, 1, 0, 0, 5, 5, 0, 0, 1, 1, 1, 0, 1, 1, 1, 0, 0, 0],
        [0, 0, 0, 1, 1, 1, 2, 1, 1, 1, 0, 5, 6, 6, 5, 0, 1, 1, 1, 2, 1, 1, 1, 0, 0, 0],
        [0, 0, 0, 0, 1, 2, 3, 2, 1, 0, 0, 5, 6, 6, 5, 0, 0, 1, 2, 3, 2, 1, 0, 0, 0, 0],
        [0, 0, 0, 0, 0, 1, 2, 1, 0, 0, 0, 0, 5, 5, 0, 0, 0, 0, 1, 2, 1, 0, 0, 0, 0, 0],
        [0, 0, 0, 0, 0, 0, 1, 0, 0, 0, 0, 0, 0, 0, 0, 0, 0, 0, 0, 1, 0, 0, 0, 0, 0, 0],
        [1, 0, 0, 0, 0, 0, 0, 0, 0, 0, 0, 0, 1, 1, 0, 0, 0, 0, 0, 0, 0, 0, 0, 0, 0, 1]
    ]
}